1111111111111111111111111111111111
1E0000C000000C000000C000000C000001
100P000000000000000000000000000001
100000C000000C000000C000000C000001
100000C000000C000000C000000C000001
100000C000000C000000C000000C000001
100000C000000C000000C000000C000001
1111111111111111111111111111111111
