



111111
1001C1
1E00P1
111111
            
