1111111111111111111
111111P011111111111
1111110C11111111111
1001C10000C00001001
1000001000000000111
1C0000C00000C1E0111
1000C11111100000001
111111111111100C111
1111111111111111111
1111111111111111111
