11111111
1E000C01
100P0001
11111111
