


111111111111111
1P0000000000011
1C0000011111111
1000E1111111111
101111111111111
101111111111111
101111111111111
111111111111111








